00000000000000000000000000000000000000000000000000000000000000000000000000000000
01111111111111111110000000000000000000000000000000000000000000000000000000000000
01222222222222222210000000000000000000000000000000000000000000000000000000000000
01222222222222222210000000000000000000000000000000000000000000000000000000000000
01222222222222222210000000000000000000000000000000000000000000000000000000000000
01222222222222222210000000000000000000000000000000000000000000000000000000000000
01222222222222222210000000000000000000000000000000000000000000000000000000000000
01222222222222222210000000000000000000000000000000000000000000000000000000000000
01222222222222222210000000000000000000000000000000000000000000000000000000000000
01222222222222222210000000000000000000000000000000000000000000000000000000000000
01222222222222222210000000000000000000000000000000000000000000000000000000000000
01222222222222222210000000000000000000000000000000000000000000000000000000000000
01222222222222222210000000000000000000000000000000000000000000000000000000000000
01222222222222222210000000000000000000000000000000000000000000000000000000000000
01222222222222222210000000000000000000000000000000000000000000000000000000000000
01111111111111111110000000000000000000000000000000000000000000000000000000000000
00000000000000000000000000000000000000000000000000000000000000000000000000000000
00000000000000000000000000000000000000000000000000000000000000000000000000000000
00000000000000000000000000000000000000000000000000000000000000000000000000000000
00000000000000000000000000000000000000000000000000000000000000000000000000000000
00000000000000000000000000000000000000000000000000000000000000000000000000000000
00000000000000000000000000000000000000000000000000000000000000000000000000000000
00000000000000000000000000000000000000000000000000000000000000000000000000000000
00000000000000000000000000000000000000000000000000000000000000000000000000000000
00000000000000000000000000000000000000000000000000000000000000000000000000000000
00000000000000000000000000000000000000000000000000000000000000000000000000000000
00000000000000000000000000000000000000000000000000000000000000000000000000000000
00000000000000000000000000000000000000000000000000000000000000000000000000000000
00000000000000000000000000000000000000000000000000000000000000000000000000000000
00000000000000000000000000000000000000000000000000000000000000000000000000000000
00000000000000000000000000000000000000000000000000000000000000000000000000000000
00000000000000000000000000000000000000000000000000000000000000000000000000000000
00000000000000000000000000000000000000000000000000000000000000000000000000000000
00000000000000000000000000000000000000000000000000000000000000000000000000000000
00000000000000000000000000000000000000000000000000000000000000000000000000000000
00000000000000000000000000000000000000000000000000000000000000000000000000000000
00000000000000000000000000000000000000000000000000000000000000000000000000000000
00000000000000000000000000000000000000000000000000000000000000000000000000000000
00000000000000000000000000000000000000000000000000000000000000000000000000000000
00000000000000000000000000000000000000000000000000000000000000000000000000000000
00000000000000000000000000000000000000000000000000000000000000000000000000000000
00000000000000000000000000000000000000000000000000000000000000000000000000000000
00000000000000000000000000000000000000000000000000000000000000000000000000000000
00000000000000000000000000000000000000000000000000000000000000000000000000000000
00000000000000000000000000000000000000000000000000000000000000000000000000000000
00000000000000000000000000000000000000000000000000000000000000000000000000000000
00000000000000000000000000000000000000000000000000000000000000000000000000000000
00000000000000000000000000000000000000000000000000000000000000000000000000000000
00000000000000000000000000000000000000000000000000000000000000000000000000000000
00000000000000000000000000000000000000000000000000000000000000000000000000000000