000000000000000000000000000000000000000000000000000000000000
000000000000000000000000000000000000000000000000000000000000
000000000000000000000000000000000000000000000000000000000000
000000000000000000000000000000000000000000000000000000000000
000000000000000000000001111111111111100000000000000000000000
000000000000000000000001222222222222100000000000000000000000
000000000000000000000001222222222222100000000000000000000000
000000000000000000000001222222222222100000000000000000000000
000000000000000000000001222222222222100000000000000000000000
000000000000000000000001222222222222100000000000000000000000
000000000000001111111111222222222222100000000000000000000000
000000000000001222222222222222222222100000000000000000000000
000000000000001222222222222222222222100000000000000000000000
000000000000001221111111222222222222100000000000000000000000
000000000000001221000001222222222222100000000000000000000000
000000000000001221000001222222222222100000011111111111100000
000000000000001221000001222222222222100000012222222222100000
000000000000001221000001222222222222100000012222222222100000
000000000111111221111101111111221111100000012222222222100000
000000000122222222222100000001221000000000012222222222100000
000000000122222222222100000001221000000000012222222222100000
000000000122222222222100000001221000000000012222222222100000
000000000122222222222100000001221000000000012222222222100000
000000000122222222222100000001221000000000012222222222100000
000000000122222222222100000001221000000000012222222222100000
000000000122222222222111111111221111111111112222222222100000
000000000122222222222222222222222222222222222222222222100000
000000000122222222222222222222222222222222222222222222100000
000000000122222222222111111111221111111111111111111111100000
000000000122222222222100000001221000000000000000000000000000
000000000122222222222100000001221000011111111111111110000000
000000000122222222222100000001221000012222222222222210000000
000000000122222222222100000001221000012222222222222210000000
000000000122222222222100000001221000012222222222222210000000
000000000111111111111100000001221000012222222222222210000000
000000000000000000000000000001221111112222222222222210000000
000000000000001111111111111001222222222222222222222210000000
000000000000001222222222221001222222222222222222222210000000
000000000000001222222222221001111111112222222222222210000000
000000000000001222222222221000000000012222222222222210000000
000000000000001222222222221000000000012222222222222210000000
000000000000001222222222221111111111111111111221111110000000
000000000000001222222222222222222222222222222221000000000000
000000000000001222222222222222222222222222222211000000000000
000000000000001222222222221111111111111111111110000000000000
000000000000001222222222221000000000000000000000000000000000
000000000000001222222222221000000000000000000000000000000000
000000000000001111111111111000000000000000000000000000000000
000000000000000000000000000000000000000000000000000000000000
000000000000000000000000000000000000000000000000000000000000
